WE ./textures/Cloudy_Mountains.xpm
    NO ./textures/door_garage.xpm
 EA ./textures/high_res.xpm
SO ./textures/Starry_Peaks.xpm

F 120,86, 18

C     56 ,  158 ,    250



11111111111111111111111111111111111111111111111111111111111111111111111111111111111111111111111111111111111
1000111111111111111111111111111111111111111111111111111111111111111111111111111111111111111111111111111111111111
1000111111111111111111111111111111111111111111111111111111111111111111111111111111111111111111111111111111111111
10E0000000000000000000000000000000000000000000000000000000000000000000000000000000000000000000000000000000011111
1000111111111111111111111111111111111111111111111111111111111111111111111111111111111111111111111111111111111111
1000111111111111111111111111111111111111111111111111111111111111111111111111111111111111111111111111111111111111
11111111111111111111111111111111111111111111111111111111111111111111111111111111111111111111111111111111111
