WE ./textures/Cloudy_Mountains.xpm
    NO ./textures/Glowing_Sea.xpm
 EA ./textures/Misty_Rocks.xpm
SO ./textures/Starry_Peaks.xpm

F 120,86, 18

C     56 ,  158 ,    250



11111
10001
10001
10E01
10001
11D11
11111
