WE ./textures/Cloudy_Mountains.xpm
    NO ./textures/Glowing_Sea.xpm
 EA ./textures/Misty_Rocks.xpm
SO ./textures/Starry_Peaks.xpm

F 120,86, 18

C     56 ,  158 ,    250



111111
100001
1000111
10E0D11
1000011
11D101
100001
111111
