 	WE ./textures/Cloudy_Mountains.xpm
	NO ./textures/Glowing_Sea.xpm
 EA ./textures/Misty_Rocks.xpm
SO ./textures/Starry_Peaks.xpm

F 120,86, 18

C	 56 ,  158 ,	250



        1111111111111111111111111
        1000000000110000000000001
        1011000001110000000000001
        100100E00D000000000000001
111111111011000001110000000000001
100000000011000000000111111111111
11110111111111000000000010001
11110111111111000001010010001
110001  110101001000000010001
100001  100000001100000010001
10000111100100001101010010001
110000011101010111110111100111
11110111 1110101 101111010001
11111111 1111111 1111111111111
