 	NO ./sprites/wall_x0_y0.xpm
	SO ./sprites/obstacle.xpm
 EA ./sprites/player_front_still.xpm
WE ./sprites/ennemy_still.xpm

F 127,254, 56 

C	 42 ,  255 ,	149 



        1111111111111111111111111
        1000000000110000000000001
        1011000001110000000000001
        1001000000000000000000001
111111111011000001110000000000001
100000000011000001110111111111111
11110111111111011100000010001
11110111111111011101010010001
110001  110101011100000010001
100001  100000001100000010001
10000111100100001101010010001
110000011101010111110111100111
11110111 1110101 101111010N01
11111111 1111111 1111111111111
