 	NO ../sprites/
	SO ../sprites/
 EA ../sprites/
WE ../sprites/

F 127,254, 56

C	 42 ,  255 ,	149



111111111111111111111111
100000000000000000000001
100000000000000000000001
100000000000000000000001
100000000000000000000001
100000000000000000000001
100000000000000000000001
100000000000000000000001
100000000000000000000001
100000000000000000000001
100000000000000000000001
100000000000000000000001
100000000000000000000001
100000000000000000000001
100000000000000000000001
1000000000000000000000N1
111111111111111111111111
