 	NO ../sprites/
	SO ../sprites/
 EA ../sprites/
WE ../sprites/

F 127,254, 56 

C	 42 ,  255 ,	149 



111111
100101
101001
1100N1
111111
