 	NO ./sprites/wall_x0_y0.xpm
	SO ./sprites/obstacle.xpm
 EA ./sprites/player_front_still.xpm
WE ./sprites/ennemy_still.xpm

F 127,254, 56

C	 42 ,  255 ,	149

              1111
              10011
              100001
1111111111111110011
100000000000000001
100000000000000001
100000001111110001
10000001     10001
1000001      1   1
1000001      1   1
100111  1111111111111111111111111111111111111111111111111
1001    1000000000110000000000001 1 1 1 1 1 1 1 1 1 1 1 1
100 1   1011000001110000000000000 1 1 1 1 1 1 1 1 1 1 1 1
100 1   1001000000000000000000001 1 1 1 1 1 1 1 1 1 1 1 1
100111111011000001110000000000000 1 1 1 1 1 1 1 1 1 1 1 1
1000000000110000000001111111111111101 1 1 1 1 1 1 1 1 1 1
11110111111111000000000010001       100000000000000000001
11110111111111000001010010001       100000000000000000001
110001  110101011100000010001       100000000000000000001
100001  100000001100000010001       100000000000000000001
10000111100100001101010010001                           1
110000011101010111110111100111      100000000000000000001
1111N111 1110101 1011110100011111111111111111111111111111
11111111 1111111 1111111111111
