 	NO ./sprites/wall_x0_y0.xpm
	SO ./sprites/obstacle.xpm
 EA ./sprites/player_front_still.xpm
WE ./sprites/ennemy_still.xpm

F 127,254, 56

C	 42 ,  255 ,	149


								1111111111111111111111111111111111111
								1000000000000000000000000000000000001
								1000000000000000000000000000000000001
								1000000000000000000000000000000000001
								1000000000000000000000000000000000001
        1111111111111111111111111010101010101010101010101010101010101
        1000000000110000000000000000000000000000000000000000000000001
        1011000001110000000000000000000000000000000000000000000000001
        1001000000000000000000001010101010101010101010101010101010101
111111111011000001110000000000001000000000000000000000000000000000001
100000000011000000000111111111111000000000000000000000000000000000001
1111011111111100S000000010001   1000000000000000000000000000000000001
11110111111111000001010010001   1111111111111111111111111111111111111
110001  110101011100000010001
100001  100000001100000010001
10000111100100001101010010001
110000011101010111110111100111
11110111 1110101 101111010001
11111111 1111111 1111111111111
