 	WE ./textures/Cloudy_Mountains.xpm
	NO ./textures/Glowing_Sea.xpm
 EA ./textures/Misty_Rocks.xpm
SO ./textures/Starry_Peaks.xpm

F 120,86, 18

C	 56 ,  158 ,	250



11111111111111111111111111111111111111111111111111111111111111111111111111111111111111111111111111111111111
1000111111111111111111111111111111111111111111111111111111111111111111111111111111111111111111111111111111111111
1000111111111111111111111111111111111111111111111111111111111111111111111111111111111111111111111111111111111111
10N0111111111111111111111111111111111111111111111111111111111111111111111111111111111111111111111111111111111111
1000111111111111111111111111111111111111111111111111111111111111111111111111111111111111111111111111111111111111
1000111111111111111111111111111111111111111111111111111111111111111111111111111111111111111111111111111111111111
11111111111111111111111111111111111111111111111111111111111111111111111111111111111111111111111111111111111